0,0,0,0,0,0,0,0,0,0,0,0,0,0,0,0,0,0,0,0,0,0,0,0,0,0,0,0,0,0,0,0,0,0,0,0,0,0,0,0,0,0,0,0,0,0,0,25,23,28,0,0,0,0,0,0,0,0,0,0,0,0,0,0,0,0,0,0,0,0,0,0,0,13,46,47,47,47,47,46,44,44,45,47,47,47,47,47,47,47,13,0,0,0,0,0,0,0,0,0
0,0,0,0,0,0,0,0,0,0,0,0,0,0,0,0,0,0,0,0,0,0,0,0,0,0,0,0,0,0,0,0,0,0,0,0,0,0,0,0,0,0,0,0,0,0,0,26,20,29,0,0,0,0,0,0,0,0,0,0,0,0,0,0,0,0,0,0,0,0,0,0,0,46,47,82,20,20,82,83,20,20,21,20,20,48,82,83,83,47,47,14,0,0,0,0,0,0,0,0
0,0,0,0,0,0,0,0,0,0,0,0,0,0,0,0,0,0,0,0,0,0,0,0,0,0,0,0,0,0,0,0,0,0,0,0,0,0,0,0,0,0,0,0,0,0,0,26,23,29,0,0,0,0,0,0,0,0,0,0,0,0,0,0,0,0,0,0,0,13,13,14,13,46,20,20,20,23,49,50,20,20,23,20,22,21,49,50,20,83,47,47,45,15,0,0,0,0,0,0
31,14,0,0,0,0,0,0,0,0,0,0,0,0,0,0,0,0,0,0,0,0,0,0,0,0,0,0,0,0,0,0,0,0,0,0,0,0,0,0,0,0,0,0,0,0,0,26,21,29,0,0,0,0,0,0,0,0,0,0,0,0,0,0,0,0,0,13,47,44,44,44,45,46,20,23,20,20,51,52,20,20,20,83,21,20,51,52,20,24,28,20,47,47,47,13,0,0,0,0
34,31,0,0,0,0,0,0,0,0,0,0,0,0,0,0,0,0,0,0,0,0,0,0,0,0,0,0,0,0,0,0,0,0,0,0,0,0,0,0,0,0,0,0,0,0,0,26,23,29,0,0,0,0,0,0,0,0,0,0,0,0,0,0,0,0,0,44,44,20,20,23,23,20,20,24,47,47,63,65,47,21,20,20,21,24,50,51,20,22,29,20,20,82,47,45,0,0,0,0
31,31,34,31,0,0,0,0,0,0,0,0,0,0,0,0,0,0,0,0,0,0,13,14,0,0,0,0,0,0,0,0,0,0,0,0,0,0,0,0,0,13,13,15,0,13,0,27,23,30,15,0,0,0,0,0,0,0,0,0,0,0,0,0,0,0,44,48,20,20,20,20,22,20,20,20,47,20,66,68,20,21,20,24,22,23,51,50,48,20,30,23,20,23,20,47,47,15,0,0
31,0,0,0,0,0,0,0,0,0,0,0,0,0,0,0,0,0,0,0,16,104,105,106,107,17,0,0,0,0,0,0,0,0,0,0,0,0,0,16,104,105,106,105,106,105,106,105,106,106,107,17,0,0,0,0,0,0,0,0,0,0,0,0,0,82,44,20,23,21,21,23,22,22,20,83,47,20,69,71,20,20,20,20,24,20,48,48,48,48,48,21,20,22,20,20,47,47,0,0
0,0,0,0,0,0,0,0,34,0,14,14,0,0,0,0,0,0,0,0,0,0,0,0,0,0,0,0,0,0,0,0,0,0,0,0,0,0,0,0,0,0,0,0,0,0,0,0,0,0,0,0,0,0,0,13,0,0,0,0,0,0,0,0,15,44,20,20,21,20,20,22,46,46,23,23,20,20,20,20,20,20,21,24,23,23,20,21,20,63,65,21,20,21,22,23,20,83,47,14
0,0,0,0,0,0,16,104,105,106,106,106,107,17,0,0,0,0,0,0,0,0,0,0,0,0,0,0,0,0,0,0,0,0,0,0,0,0,0,0,0,0,0,0,0,0,0,0,0,0,0,0,0,16,104,105,106,107,17,0,0,0,0,0,44,44,44,82,44,44,20,20,22,23,20,20,20,23,20,20,20,20,20,24,20,20,21,22,21,69,71,32,20,20,21,20,46,46,47,47
0,0,0,0,0,0,0,0,0,0,0,0,0,0,1,40,41,42,43,2,0,0,0,0,0,0,49,0,0,0,0,0,0,0,0,0,0,0,0,0,0,0,0,0,0,0,0,0,0,0,0,0,0,0,0,0,0,0,0,0,0,0,0,0,25,49,20,20,22,28,20,21,22,20,0,0,23,20,20,21,0,0,24,24,24,21,0,0,20,20,20,20,23,20,20,63,64,65,46,83
0,0,0,0,0,0,0,0,0,0,0,0,0,0,0,3,4,5,5,0,0,0,0,0,0,0,49,0,0,0,0,0,0,0,0,0,0,0,0,0,0,0,0,0,0,0,0,0,0,0,0,0,0,0,0,0,0,0,0,0,0,0,0,0,27,49,22,21,24,30,20,20,22,22,0,0,24,20,22,20,0,0,23,23,20,21,0,0,24,20,23,20,22,20,20,66,67,101,83,46
0,16,104,105,106,107,17,0,0,0,0,0,0,0,1,40,41,42,43,2,0,0,0,0,0,0,49,0,0,0,0,0,0,0,0,0,0,0,0,0,0,0,0,0,0,0,0,0,0,0,0,0,0,0,0,0,0,0,0,0,0,46,44,44,44,44,83,44,44,46,20,20,22,20,0,0,23,20,23,20,0,0,22,24,20,24,0,0,20,20,21,21,20,23,46,66,67,68,46,47
0,0,0,0,0,0,0,0,0,0,0,0,0,0,0,3,4,5,5,0,0,0,0,0,0,0,49,0,0,0,0,0,0,13,0,0,14,0,0,0,0,0,0,0,0,0,0,0,0,0,0,0,0,0,0,0,0,0,0,0,46,46,20,20,28,20,23,24,20,28,20,21,23,20,13,0,24,24,22,20,15,0,20,23,20,24,13,0,20,21,20,45,20,20,46,66,67,68,46,48
0,0,0,0,0,0,0,0,13,0,15,0,0,0,1,40,41,42,43,2,0,0,0,0,0,0,49,0,0,0,0,0,1,40,41,42,43,2,0,0,0,0,0,0,0,0,0,0,0,0,0,0,0,0,0,0,0,0,0,14,46,20,20,23,29,20,20,23,22,29,20,22,20,20,31,31,24,20,22,23,31,31,23,20,24,24,31,31,20,24,24,22,20,21,46,69,70,71,45,82
34,13,0,0,0,0,16,104,105,106,107,17,0,0,0,3,4,12,5,0,0,0,0,0,0,0,49,0,0,0,0,0,0,3,4,5,6,0,0,0,0,0,0,0,0,0,0,0,0,0,0,0,0,0,0,0,0,0,15,47,45,82,44,20,29,23,20,63,64,65,20,20,20,20,20,22,24,20,22,21,21,22,20,20,20,21,21,20,20,24,20,20,21,21,28,20,22,23,32,32
33,32,0,0,0,0,0,0,0,0,0,0,0,0,1,40,41,42,43,2,0,0,0,0,0,0,49,0,0,0,0,0,1,40,41,42,43,2,0,0,0,0,0,0,0,0,0,0,0,0,0,0,0,0,0,0,0,0,44,48,20,20,23,20,29,20,20,66,67,68,20,23,20,21,20,20,20,63,65,24,20,21,21,63,65,20,23,23,24,20,20,24,20,20,29,21,24,20,32,32
32,34,14,0,0,0,0,0,0,0,13,0,0,0,0,8,9,10,11,0,0,0,0,0,0,0,49,13,0,15,0,0,13,8,9,12,11,0,0,0,0,0,0,0,13,0,0,0,0,0,15,0,0,0,0,0,14,14,44,44,33,31,20,20,30,23,49,69,70,71,46,23,20,20,22,24,20,69,71,20,23,20,24,69,71,45,20,20,20,20,21,24,20,20,30,20,24,20,32,32
42,42,42,42,42,43,2,0,1,40,42,42,42,42,42,42,42,42,42,43,2,0,0,0,0,1,40,42,42,42,42,42,42,42,42,42,42,43,2,0,0,1,40,42,43,2,0,0,1,40,42,43,2,0,0,1,40,42,42,42,42,42,42,42,42,42,42,42,42,42,42,42,42,42,42,42,42,42,42,42,42,42,42,42,42,31,20,20,20,20,31,42,42,42,42,42,42,42,42,42
61,61,61,61,61,62,58,58,58,59,61,61,61,61,61,61,61,61,61,62,58,58,58,58,58,58,59,61,61,61,61,61,61,61,61,61,61,62,58,58,58,58,59,61,62,58,58,58,58,59,60,62,58,58,58,58,59,61,61,61,61,61,61,61,61,61,61,62,61,61,61,61,61,61,61,61,61,61,61,61,61,61,61,61,61,31,58,58,58,58,31,61,61,61,61,61,61,61,61,62
80,80,79,80,80,81,77,77,77,78,80,80,80,80,80,80,80,80,80,81,77,77,77,77,77,77,78,80,80,80,80,80,80,80,80,80,80,81,77,77,77,77,78,80,81,77,77,77,77,78,79,81,77,77,77,77,78,80,80,80,80,80,80,80,80,80,80,81,80,80,80,80,80,80,80,80,80,80,80,80,80,80,80,80,80,31,77,77,77,77,31,80,80,80,80,80,80,80,80,81
77,77,77,77,77,77,77,77,77,77,77,77,77,77,77,77,77,77,77,77,77,77,77,77,77,77,77,77,77,77,77,77,77,77,77,77,77,77,77,77,77,77,77,77,77,77,77,77,77,77,77,77,77,77,77,77,77,77,77,77,77,77,77,77,77,77,77,77,77,77,77,77,77,77,77,77,77,77,77,77,77,77,77,77,77,31,77,77,77,77,31,77,77,77,77,77,77,77,77,77
77,77,77,77,77,77,77,77,77,77,77,77,77,77,77,77,77,77,77,77,77,77,77,77,77,77,77,77,77,77,77,77,77,77,77,77,77,77,77,77,77,77,77,77,77,77,77,77,77,77,77,77,77,77,77,77,77,77,77,77,77,77,77,77,77,77,77,77,77,77,77,77,77,77,77,77,77,77,77,77,77,77,77,77,77,31,77,77,77,77,31,77,77,77,77,77,77,77,77,77
77,77,77,77,77,77,77,77,77,77,77,77,77,77,77,77,77,77,77,77,77,77,77,77,77,77,77,77,77,77,77,77,77,77,77,77,77,77,77,77,77,77,77,77,77,77,77,77,77,77,77,77,77,77,77,77,77,77,77,77,77,77,77,77,77,77,77,77,77,77,77,77,77,77,77,77,77,77,77,77,77,77,77,77,77,31,77,77,77,77,31,77,77,77,77,77,77,77,77,77
77,77,77,77,77,77,77,77,77,77,77,77,77,77,77,77,77,77,77,77,77,77,77,77,77,77,77,77,77,77,77,77,77,77,77,77,77,77,77,77,77,77,77,77,77,77,77,77,77,77,77,77,77,77,77,77,77,77,77,77,77,77,77,77,77,77,77,77,77,77,77,77,77,77,77,77,77,77,77,77,77,77,77,77,77,31,77,77,77,77,31,77,77,77,77,77,77,77,77,77
77,77,77,77,77,77,77,77,77,77,77,77,77,77,31,31,31,31,31,31,31,31,31,31,31,31,77,77,77,77,77,77,77,77,77,77,77,77,77,77,77,77,77,77,77,77,77,77,77,77,77,77,77,77,77,77,77,77,77,77,77,77,77,77,77,77,77,77,77,77,77,77,77,77,77,77,77,77,77,77,77,77,77,77,77,31,77,77,77,77,31,77,77,77,77,77,77,77,77,77
77,77,77,77,77,77,77,77,77,77,77,77,77,77,31,24,24,24,24,24,24,24,24,24,24,31,77,77,77,77,77,77,77,77,77,77,77,77,77,77,77,77,77,77,77,77,77,77,77,77,77,77,77,77,77,77,77,77,77,77,77,77,77,77,77,77,77,77,77,77,77,77,77,77,77,77,77,77,77,77,77,77,77,77,77,31,77,77,77,77,31,77,77,77,77,77,77,77,77,77
77,77,77,77,77,77,77,77,77,77,77,77,77,77,31,24,24,24,24,24,24,24,24,24,24,31,77,77,77,77,77,77,77,77,77,77,77,77,77,77,77,77,77,77,77,77,77,77,77,77,77,77,77,77,77,77,77,77,77,77,77,77,77,77,77,77,77,77,77,77,77,77,77,77,77,77,77,77,77,77,77,77,77,77,77,31,77,77,77,77,31,77,77,77,77,77,77,77,77,77
77,77,77,77,77,77,77,77,77,77,77,77,77,77,31,24,24,24,0,0,24,24,24,24,24,31,31,31,31,31,31,31,31,31,31,31,77,77,77,77,77,77,77,77,77,77,31,31,31,31,31,31,31,31,31,31,31,31,31,31,31,31,31,31,31,31,31,31,31,31,31,31,31,31,31,31,31,31,31,31,31,31,31,31,31,31,77,77,77,77,31,77,77,77,77,77,77,77,77,77
77,77,77,77,77,77,77,77,77,77,77,77,77,77,31,24,24,0,0,0,24,24,24,24,24,24,24,24,24,24,24,24,24,24,24,31,77,77,77,77,77,77,77,77,77,77,31,20,20,20,20,20,20,20,20,20,20,20,20,20,20,20,20,20,20,20,20,20,20,20,20,23,23,23,20,20,23,23,23,23,20,20,20,20,20,31,31,20,31,31,31,77,77,77,77,77,77,77,77,77
77,77,77,77,77,77,77,77,77,77,77,77,77,77,31,24,24,0,0,0,24,24,24,24,24,24,24,24,24,24,24,24,24,24,24,31,77,77,77,77,77,77,77,77,77,77,31,20,20,20,20,20,20,20,20,20,20,20,20,20,20,20,20,20,20,20,20,20,20,20,20,20,20,20,23,23,23,23,20,20,20,20,20,20,20,20,22,22,22,22,31,77,77,77,77,77,77,77,77,77
77,77,77,77,77,77,77,77,77,77,77,77,77,77,31,24,24,0,0,0,0,0,0,0,0,0,0,0,24,24,24,24,24,24,24,31,77,77,77,77,77,77,77,77,77,77,31,20,20,20,20,20,20,20,20,20,20,20,20,20,20,20,20,20,20,20,20,20,20,20,20,20,20,20,20,20,20,20,20,20,20,20,20,20,20,20,0,0,0,0,31,31,31,31,77,77,77,77,77,77
77,77,77,77,77,77,77,77,31,31,31,31,31,31,31,24,24,0,0,0,0,0,0,0,0,0,0,0,0,0,0,0,0,24,24,31,77,77,77,77,77,77,77,77,77,77,31,0,0,0,0,0,0,0,0,20,20,20,20,20,20,20,20,20,20,20,20,20,20,20,20,20,20,20,20,20,20,20,20,20,20,20,20,20,20,0,0,0,0,0,0,0,0,31,77,77,77,77,77,77
77,77,77,77,77,77,77,77,31,24,24,24,24,24,24,24,0,0,0,0,0,0,0,0,0,0,0,0,0,0,0,0,0,24,24,31,77,77,77,77,77,77,77,77,77,77,31,0,0,0,0,0,0,0,0,0,0,20,20,20,20,20,20,20,20,20,20,20,20,20,20,20,20,20,20,20,20,20,20,20,20,20,20,0,0,0,0,0,0,0,0,0,0,31,77,77,77,77,77,77
77,77,77,77,77,77,77,77,31,24,24,24,0,49,49,49,49,49,0,0,0,0,0,0,0,0,0,0,0,0,0,0,24,24,24,31,77,77,77,77,77,77,77,77,77,77,31,0,20,20,0,0,0,0,0,0,0,0,0,0,0,0,0,0,0,0,0,0,0,0,0,0,20,20,20,20,20,20,20,0,0,0,0,0,0,0,0,0,0,0,0,0,0,31,77,77,77,77,77,77
77,77,77,77,77,77,77,77,31,0,0,0,0,49,0,0,0,49,0,0,0,0,0,0,0,0,0,0,0,0,0,0,24,24,24,31,31,31,31,31,31,31,31,31,31,31,31,0,20,20,20,0,0,0,0,0,0,0,0,0,0,20,20,0,0,0,0,0,20,0,0,0,0,0,0,0,0,0,0,0,0,0,0,0,0,0,0,0,0,0,0,22,22,31,77,77,77,77,77,77
77,77,77,77,77,77,77,77,31,0,0,0,0,49,0,0,0,49,0,0,0,0,0,0,0,0,0,0,0,0,0,0,0,0,0,49,49,0,0,0,0,0,0,0,49,49,49,0,0,0,0,0,0,0,0,0,0,0,0,0,0,0,0,0,0,0,0,0,0,0,0,0,0,0,0,0,0,0,0,0,0,0,0,0,0,0,0,0,0,22,22,22,22,31,77,77,77,77,77,77
77,77,77,77,77,77,77,77,31,31,31,31,31,31,31,31,31,31,31,31,31,31,31,31,31,31,31,31,31,31,31,31,31,31,31,31,31,31,31,31,31,31,31,31,31,31,31,31,31,31,31,31,31,31,31,31,31,31,31,31,31,31,31,31,31,31,31,31,31,31,31,31,31,31,31,31,31,31,31,31,31,31,31,31,31,31,31,31,31,31,31,31,31,31,77,77,77,77,77,77
